1111111111111111111111111
1111111111111111111111111
1111111111111111111111111
1100000000000000000000000
1100000000000000000000000
1100000000000000000000000
1100000000000000000000000
1100000000000000000000000
1100000000000000000000000
1100000000000000000000000
1100000000000000000000000
1100000000000000000000000
1100000000000000000000000
1100000000000000000000000
1101111111111111111111111
1101111111111111111111111
1101111111111111111111111
