1000000000000000000000000
1000000000000000000000000
0000000000000000000000000
1110000000000000000000000
1111000000000000000000000
1111100000000000000000000
1111114000000000000000005
1111111000000000000000000
1111111100000000000000000
1111111110000000000000000
1111111111000000000000000
1111111111100000000000000
1111111111110000000000000
1111111111111400000000005
1111111111111100000000000
1111111111111110000000000
1111111111111111111111111
