1111111111100011111111111
1111111110000111111111111
1111111111000000011111111
1111111111000011111111111
1111111111110000111111111
1000000000000000111111111
1000000000011111111111111
1000001111111111111111111
1000000000000000000000001
1110000000000000000000001
1000000111100000000000001
1000000000000000000c00001
1000000000000011111111111
1000000000000111000000001
0000011111000000000000001
1111111111111111111111111
1111111111111111111111111