1000011111111111111111111
1000111111111111111111111
1100000000000000000000001
1000110000000000000000001
1000000001100000000000001
1000000000000011000000001
1000000000000000000011111
1000000000000000000111111
1000000000000000011111111
1000000000001110000011111
1000000111000000000000111
1001111111000000000000001
1100000000000000000000001
1000011000000000000000001
1110000000000000000000001
1111100000000000000000001
1111111111111111111000001