1111111111111111111000001
1111111111111111111000011
1111111111111111111000111
1111111111111111111000011
1111111111111111110000111
1111111111111111111000111
1111111111111111110000111
1111111111111111111000111
1000000000000000000001111
1000000000001110001111111
1000000111000000000000111
1001111111000000000000001
1100000000000000000000001
1000011000000000000000001
1110000000000000000000001
0000011100000000000000001
1111111111111111111111111