1000011111111111111111111
1001111111111111111111111
1100000000000000000011111
1000111000000000000011111
1000000001110000000011111
1000000000000011100011111
1000000000000000000111111
1000000000000000001111111
1000000000000000011111111
1000000000000000111111111
1000000000000001111111111
0000000000001111111111111
0000000001111111111111111
0000001111111111111111111
1111111111111111111111111
1111111111111111111111111
1111111111111111111111111