0000000000000000000000000
0000000000000000000000000
0000000000000000000000000
0000000000000000000000000
0000000000000000000000000
0000000000000000000000000
0000000000000000000000000
0000000000000000000000000
0000000000000000000000000
0000000000000000000000000
0000000000000000000000000
0000000000106000000000000
0000110000011000000000000
0000000000011100000000000
1111111111111111111111111
1111111111111111111111111
1111111111111111111111111
