0000000000000000000000000
0000000000000000000000000
0000000000000000000000000
0000000000000000000000000
0000000000000000000000000
0000000000000000000000000
0000000000000000000000000
0000000000000000000000000
0000000000000000000000000
0000000000000000000000000
0000000000000000000000000
0000000000006000000000000
0000000000001000000000000
0000000000011100000000000
1111111111111111111111111
1111111111111111111111111
1111111111111111111111111
