1111111111111111111111111
1111111111111111111111111
1000000000000000000000000
1000000000000000000111111
1000000000000000011111111
1000000000000001111111111
1000000020000111111111111
1111000011111111111111111
1000000001111111111111111
1000011111111111111111111
1110001111111111111111111
0000011111111111111111111
0000111111111111111111111
0000011111111111111111111
1111111111111111111111111
1111111111111111111111111
1111111111111111111111111
