1000000000000000000000000
1000000000000000000000000
1000000000000000000000000
10000000000000000000000c0
1000000000000000000000011
1000000000000000000003111
1000000000000000000000011
1000000011000000000000111
1000000001000000000000011
1000000001000000000000111
1000001101000000003000011
1000011001000001000000111
1--0001001000001000000011
11-0011001031111111000111
1111111100011111111100111
1111111111111111111100111
1111111111111111111100111
