0000000000000000000000000
0000000000000000000000000
0000000000000000000000000
00000000000000000000000c0
0000000000000000000000011
0000000000000000000003111
0000000000000000000000011
0000000011000000000000111
0000000001000000000000011
0000000001000000000000111
0000001101000000003000011
0000011001000001000000111
0--0001001000001000000011
11-0011001031111111000111
1111111100011111111100111
1111111111111111111100111
1111111111111111111100111
