1111111111111111111111111
1111111111111111111111111
--00000000000000000000h01
--00000000000000000111101
1100000000000000001111001
1000001110001100001900011
1100000000000000011111001
1111000000000000001110011
1111000009999999991100111
1111110001111111111001111
1111110001111111100011111
1111190009111111110011111
1111110001511111111001111
1111190009111111111100111
1111410001111111111110111
1111110000000000000000000
1111110001111111111111111
