1111111111111111111111111
11111111110008000000c0011
1111111111000000111111001
1111111111011111111110011
1111111111000000111111001
1111111111111110111100011
1111111111000800111111001
1111111111011111111100011
1111111111000000111111001
1111111111111110111100011
1111111111000800111111001
1111111111011111111100011
1111111111000800111111011
1111111111111110111100011
--11111111000000111000111
--00000000011111111100001
1111111111111111111110011
