11111111111111110000---01
11111111111111110000---01
1111111111111111000000001
1111111111111111040000001
1111111111111111000000501
1111111111111111000000001
1111111111111111000000001
1111111111111111000000051
1111111111111111004000001
1111111111111111000000001
11111111111111110h0000001
1111111111111111040000001
1111111111111111000000000
1111111111111111000000001
1111111111111111111111111
1111111111111111111111111
1111111111111111111111111
