100001010000000000000000
1000010100000000000000000
1000000000000000000000000
1000000000000000000000000
1000000000000000000000000
1000000000000000000000000
1000000000000000000000000
1000000000000000000000000
1000000000000000000000000
1000000000000111100000000
1000011110000000000000000
0000000000010000000011111
0010000000000000000000000
0119999999999999999999999
1111111111111111111111111
1111111111111111111111111
1111111111111111111111111
