000000--00000000000110011
000000--00000000000111001
0c00000000000000000000011
1110000000001110000000011
0000111000000000000000111
0000000001110000000011111
1100000000000000000000001
0011100000010000000000001
000000010000000h000000001
0000000000100011100000001
0000001110000000001000001
1111100000011111000011111
1111100000000000000000000
1111199999999999999999999
1111111111111111111111111
1111111111111111111111111
1111111111111111111111111
