0000000000000000000000000
0000000000000000000000000
0000000000000000000000000
0000000000000000000000000
0000000000000000000000000
0000000000000000000000000
0000000000000000000000000
0000000000000000000000000
0000000000000000000000000
0000000000000000000000000
0000000000000000000000000
000000000h000000060000000
0--0000001000000010000000
0--0000011100000111000000
1111111111111111111111111
1111111111111111111111111
1111111111111111111111111
