1111111111000000110011111
1111111111000000110111111
1111111111000000110011111
1111111111000000110111111
1111111111000000110011111
1111111111000000110111111
1111111111000000110011111
1111111111000000110111111
1111111111000000000000000
1111111111111111111111111
1111111111111111111111111
1111111111111111111111111
1111111111111111111111111
1111111111111111111111111
1111111111111111111111111
1111111111111111111111111
1111111111111111111111111
