1000000000000000000000001
1000000000000000000000001
1000000000000000000000001
1000001111100000000000001
1000001111100000000000001
1000001111100000000000001
100000000000100000000c001
1100010000000000000000001
0000000999901000000000001
1000010000000000000000001
1000000000000000000000001
1000000100000000000000001
1111111111111111111111111
1111111111111111111111111
1111111111111111111111111
1111111111111111111111111
1111111111111111111111111
