0000000000000000000000000
0000000000000000000000000
0000000000000000000000000
0000000000000000000000000
0000000000000000000000000
0000000000000000000000000
0000000000000000000000000
0000000000000000000000000
0000000006000000000000000
0000000060000000000000000
0000000600000000000000000
0000006000000000000000000
1--0000000000000000000000
1--0000000000000000000000
1111111111111111111111111
1111111111111111111111111
1111111111111111111111111
