0000000000000000000000000
0000000000000000000000000
0000000000000000000000000
0000000000000000000000000
0000000000000000000000000
0000000000000000000000000
0000000000000000000000000
0000000000000000000000000
0000000000000000000000000
0000000080000009700000000
0000000800000000000000000
0000008000000900000000000
1--0080000000000000000000
1--0000000000000000000000
1111111111111111111111111
1111111111111111111111111
1111111111111111111111111
