1999990777770000000000001
1999999777770000000000001
1999100777770000000000001
199910h707070000000000001
1999101717171111111110001
1999100999991999111100010
1999100111111999000000110
1999100000001999099011110
1999177000001111019000000
1999177000000000019109901
1111177000011111999999991
1000177000999999111111111
1010077009999999999999991
1019999999999999999999991
1011111111111111111111111
1011111111111111111111111
1011111111111111111111111
