0000000000000000000000000
0000000000000000000000000
0000000000000000000000000
0000000000000000000000011
0000000000000011100000001
0000000000000000000000001
0000000000100000000000001
0000000016100000000000001
00000001611100000h0000001
1000001611110000000000001
1000016111119999999999991
1001161111111111111111111
1--0000000000000600000000
1--0000000000990009900000
1111111111111111111111111
1111111111111111111111111
1111111111111111111111111
