1000000000000000000000000
1000000000000000000000000
0000000000000000000000000
1111111111000000111009111
1111111111000000199109111
1111111111000000190009111
1111111114000000590199111
1111111111008800190009111
1111111111000000199109111
1111111111000000190009111
1111111111000000190199111
1111111111000000190009111
0000000000000000000100001
0000000000000000000000001
1111111111000000111111111
10000000c1000000111111111
1000000111000000111111111
