0000111111111111111111111
0000100000000000000000001
0000101000000000000000001
1110101000000hhh0000000h1
1000001100000h000000000h1
1001001000000hh00hhh00hh1
1999991100000h000h0h0h0h1
1111111000000hhh0h0h0hhh1
1000000001111111111111111
1000000010000000010000000
1000000100000000001000000
1000011000001111111100000
1111000000000000001000000
1000011000000000010000000
1000000001111100000000000
1000000000000100000000000
1111111111100111111111111
