1000000000000000000000001
1000000000000000000000001
1000000000000000000000001
1010000000000000000000001
1000000000000000000000001
1010000000000000000000001
1000000000000000000000001
1010000000000000000000001
10000000000000000000000c1
1000100000000000000000001
0000000100000000000000001
0000000000000000000000001
0000000100000000000000001
0000100000000000000000001
0100000000000000000000001
0000000000000000000000001
1199999999999999999999991
