1010000000000000000000000
1010000000000000000000000
1010000000000000000000000
1000100000000000000000000
1999100000000000000000000
1991100000000000000000000
1111000000000000000000000
1000000000000000000000000
1000000000000000000000000
1888888888888888888888888
1999999999999999999999999
1999999999999999999999999
1999999999999999999999999
1999999999999999999999999
1999999999999999999999999
1999999999999999999999999
1111111111111111111111111
