1111011111011111111111111
0111111111111111111111111
1111111111111111111111111
1111111111111111111111111
1111111111111111111111111
1111111111111111111111111
0111111111111111111111111
1111111111111111111111111
0000000999999999999999999
0000000999999999999999999
1000009999999999999999999
1000099999999999999999999
1000999999999999999999999
1009999999999999999999999
1001999999999999999999999
1001999999999999999999999
10019999999999999999991c1
