1333300111000000111111111
1010000111000000111111111
1333300111000000111111111
1333301111000000111111111
1333300111000000111111111
1010000111000000111111111
1333300111000000111111111
1333301111000000111111111
1333300111000000111111111
1010000111000000111111111
1333300111000000111111111
1333301111000000111111111
1333300111000000111000000
1010000111000000110000000
1000000111000000110011111
1010001111000000110000111
1010011111000000111100111
