1111111111100119000000001
1000000000001119000000001
1000000000100119000000001
1000000000000119000900101
1000000000001190009900001
1000000000011900099900101
1000000000119000999900001
1000000001190009999900101
1000000011000099999900001
1000000000000000000000101
1000000111000000000000001
1000000000000000000000101
0000000000000000010000001
0000000000000000000000001
1111110000000100000000001
1111110000000000000000001
1111119999999999999999991
