1000000000000000000000001
1000000000000000000000001
1000000000000000000000001
1022222200000000000000001
1200000000000000000000001
1200000000000000000000001
1200000000000000000000001
1200000000000000000000001
1022222200000000000000001
1000000000000000000333331
1000000000000000003000001
1000000000000000003000001
1000000000000000000333301
1000000000000000000000031
1000000000000000000000031
1000000000000000003333301
1000000000000000000000001
