1111111111111111111111111
1000000000000000000000000
1888888888888088888888888
1888888888888808888888888
1888880000000000888888888
1888888888888808888888888
1888888888888088888888888
1000000000000000000000001
1000000000000100000000001
1000000000000010000000001
1000001111111111000000001
1000000000000010000000001
1000000000000100000000000
1000000000000000000000000
1111111111111111111111111
1111111111111111111111111
1111111111111111111111111
