1001111111111111111111101
1000000000000000000000001
1011111111111111111111001
1000900000000000000000001
1100900000000000000000001
1111111111100011111111111
1001000000000000000001001
1001000000000000000001001
1001000000000000000001001
1001000000000000000001001
1000000000000000000000001
1001111111111111111111001
0000000000009000000000000
0000000000009000000000000
1111111111111111111111111
1111111111111111111111111
1111111111111111111111111
