1010011111000000111100111
1011000011000000111110111
1011100011000000110000111
1014000011000000110001111
1011600011000000110011100
1010000011000000110111101
1010000114000000510000101
1010000011000000111000101
1010100011000000111100101
1010000011000000111110101
1014100011000000110000101
1011000011000000110001101
0011000111000000110011101
0000000000000000000000001
1111111111000000111111111
1111111111000000111111111
1111111111000000111111111
