1010011111000000111100111
1011000011000000111110111
1011100011000000110000111
1014000011000000110001111
1011600011000000110011111
1010000011000000110111111
1010000114000000510000111
1010000011000000111000111
1010100011000000111100111
1010000011000000111110111
1014100011000000110000111
1011000011000000110001111
1011000111000000110011111
0000000000000000000111111
1111111111000000111111111
1111111111000000111111111
1111111111000000111111111
