1000000000000000000000001
1000000000000000000000001
1000000000000000000000001
1222222000000000000000001
1000020000000000000000001
1000020000000000000000001
1000020000000000000000001
1200020000000000000000001
1022200000000000000000001
1000000000000000003333301
1000000000000000003000031
1000000000000000003000031
1000000000000000003333301
1000000000000000003000031
1000000000000000003000031
1000000000000000003000031
1000000000000000000000001
