0000000000000000000000000
0000000000000000000000000
0000000000000000000000000
0000000000000000000000000
0000000000000000000000000
0000000000000000000000000
0000000000100000000000000
0000000001600000000000000
0000000016100000000000000
1000000161100000000000000
1000001611100000000000000
1001116111111111111111111
1--0000000000000900000000
1--0000000000990009900000
1111111111111111111111111
1111111111111111111111111
1111111111111111111111111
