1111111111000000111111111
1111111111000000111111111
1111111111000000111111111
1111111111000000111111111
1111111111000000111111111
1111111111000000111111111
1111111111000000111111111
1111111111000000111111111
1111111111000000111111111
1111111111000000111111111
1111111111000000111111111
1111111111999999111111111
1111111111999999111111111
1111111111999999111111111
1111111111999999111111111
1111111111999999111111111
1111111111111111111111111
