1000000000000000000000000
1000000000000000000000000
000000000000000000000000c
1111111111000000110011111
1111111111000000110111111
1111111111000000110011111
1111111114000000510111111
1111111111000000110011111
1111111111000000110111111
1111111111000000110011111
1111111111000000110111111
1111111111000000110011111
1111111111000000110111111
1111111114000000510011111
1111111111000000110111111
1111111111000000100011111
1111111111000000110011111
