1000000000000000000000001
1000000000000000000000001
1222200000000000000000001
1200020000000000000000001
1222200000000000000000001
1200020000000000000000001
1222200000000000000000001
1000000000000000000000001
1000000000000000003333301
1000000000000000000030001
1000000000000000000030001
1000000000000000000030001
1000000000000000000030001
10000000000c0000000000001
1000000000000000000000001
1999999999999999999999991
1111111111111111111111111
