1111111111111111111111111
1001000000000010000000001
1111000000100010000111101
1000016101111011104100001
1000000000100000000111001
1001100110101101111101001
1010000010000101000001001
1000000010000101011011101
1111111011110101110010101
1000000000000100000100001
1000001111110111110100001
1000011000000000100101101
1000111101111111101101000
1000111000000000101001111
1001111101111111111001111
1111111110000000000011111
1111111110111111111111111
