1000000000000000000000001
1000000000000000000000001
1000000000000000000000301
1000000000000000000000001
1200000000000000003000001
1000000000000000000000001
1000000200000000000003001
1200000000000000000000001
1000000000000000000300001
1020000000000000000000001
1000000000000000000000031
1200000000000300000000001
1000000000000000000000001
1200000000000000000300001
1000000000000003000000001
1000000000000000000000001
1000000000000000000000001
