1111111111111111111111111
0000000000000000000000001
0000000000000000000000001
0000000000000000000000001
0000000000000000000000001
0000000000000000000000001
0001000000000000000000001
0000000000003000600000001
0000000100000000000000001
1005000000000100000000001
1000000100000000000000001
1010000000000000000000001
1000000010000000000000001
1000000000001000000000001
1000000000000000000100001
1005000000001000000000001
1000000000000001100000001