1111111111111111111111111
0000000000000000000000001
0000000000000000000000001
0000000000000000000000001
0000000000000000000000001
0000000000000000000000001
0001000000000000000000001
0000000000003000600000001
0000000100000000000000001
0005000000000100000000001
0000000100000000000000001
0010000000000000000000001
0000000010000000000000001
0000000000001000000000001
0000000000000000000100001
0005000000001000000000001
0000000000000001100000001