1000000000000000000000001
1000000000000000000000001
1111111101111111011111111
1000000101000001001000001
1000000101000001011000001
1000000101000001001000001
1000000101000001016111111
1000000101000001000000000
1000000101000001111111111
1000000101000000000000001
1000000101000000000000001
1000000101111111111110001
1000000100000000000010001
1000000111111111111010001
1000000000000000001010001
1000000000000000001010001
1000000000000000001010001
