0000000000000000000000000
0000116111161111000000000
0000100000000001000000000
0000100000000001000000000
0000100000000001111100000
00001000000000000h0100000
1111100000000000111100000
0000000000000000000100000
1111111151111100000100000
0000000000000100000100000
0000000000000100000100000
0000000000000111111100000
0000000000000000000000111
0000000000000000001100000
0000000000000010000000000
0000000000100000000000000
0000111100000000000000000