0001000100000000000000011
0001100000111111111111111
0001000100000000000000000
0001100000000000000000011
0001110000111000001100001
0000000000000000000000011
0006320600362006023601001
0000000000000000000000011
0000000000000000000001001
0000000000000000000000011
0000000000000000000001001
0h00000000000000000000011
1111111115111111151111111
0000000000000000000000001
0000000000000000000000001
0000000000000000000000001
0000000000000000000000001