0001000000000000000000001
1111100000000001000000111
0000000000000001000000011
1111100000000001000000111
1000000000000001000000011
1000200000000001000000111
1000000000030001000000011
1000000000000001000000111
1000000111111111000000011
1000000000000000000000111
1000000000000000000000011
1000000000000000000000111
1000000000010000000000011
1000000000000001000000111
12000002002000011100c0011
1000300003003000111111111
1111111111111111111111111