1000000000000000001010000
1000000000000000001010000
1000000000000000001010000
1000000000300000000010000
1111110001111111611110000
1000000000000000000000000
1000000000000000000000000
1011111111111000000000000
1000000000000000000000000
1000000000000000000000000
1000000000001710000000000
1110000000001000000000300
1000000001001111111111100
1000000011000000000000000
1000011111000000000000000
1000000000000001111111111
1000000000000000000000000

