0000000100000000000000001
000000011000000000000c001
0000611111100000000011101
0000000000110001100000001
0000000000000000000000001
0000000000001000000000001
0000001000000000511000001
0010000000000000000001001
1111000000100060000000011
0000011000000011100010001
0000000000000000000000011
0000000110000000000001111
0000000000001000001000001
0000000000000001000000001
0000000000001111000000001
0000001110300300020002001
1111111111111111111111111
